21
21
WWWSLLLLLLAAAAAAAAAAA
WWWXLLLLLLLAAAAAAAXXS
WWAXXLLLLLLLAAAAAXXWW
WWAAXPLLLLLLAAAAXXRWW
WAAAXPPPPLWWAAAAXRRWW
AAAAXPPPPWWWWWWWXRRWW
AARRXLLLLWWWWWWXXXRWW
FXXXXXLLLWWWWXXXPXWWW
LLLLLXXXLWWXXXPPPXWWW
LLLLLLLXXXXXWWPPPXWWA
LLLLLLLXRRRWWWPPPXXAA
LLLLLLAXWWWWWWWAAAXAA
LLAAAAAXWWWWWWAAAAXAA
AAAAAXXXWWWWWAAAAAXXA
AAXXXXRXWWWWWAAAAAAXA
SXXRRRRXXXWWWAAAAAAXF
AAAAAAAAAXXXWWLLLLLLL
AAAWWWWWWWWXXXXXLLLLL
AAAWXXXXXXXXRRRXXXLLL
AAWWXLLLLLLLLLLWWXPPP
AAWWSLLLLLLLLWWWWFPPP
24
1 3
2 2
3 2
4 3
5 2
6 3
7 3
8 2
9 2
10 3
11 2
12 3
13 2
14 2
15 2
16 3
17 3
18 3
19 2
20 3
21 3
22 2
23 2
24 3