21
21
WWWSLLLLLLAAAAAAAAAAA
WWWXLLLLLLLAAAAAAAXXS
WWAXXLLLLLLLAAAAAXXWW
WWAAXPLLLLLLAAAAXXRWW
WAAAXPPPPLWWAAAAXRRWW
AAAAXPPPPWWWWWWWXRRWW
AARRXLLLLWWWWWWXXXRWW
FXXXXXLLLWWWWXXXPXWWW
LLLLLXXXLWWXXXPPPXWWW
LLLLLLLXXXXXWWPPPXWWA
LLLLLLLXRRRWWWPPPXXAA
LLLLLLAXWWWWWWWAAAXAA
LLAAAAAXWWWWWWAAAAXAA
AAAAAXXXWWWWWAAAAAXXA
AAXXXXRXWWWWWAAAAAAXA
SXXRRRRXXXWWWAAAAAAXF
AAAAAAAAAXXXWWLLLLLLL
AAAWWWWWWWWXXXXXLLLLL
AAAWXXXXXXXXRRRXXXLLL
AAWWXLLLLLLLLLLWWXPPP
AAWWSLLLLLLLLWWWWFPPP
1 4
2 3
3 4
4 5
5 2
6 3
7 2
8 4
9 5
10 3
11 5
12 4
13 3
14 4
15 1
16 3
17 4
18 2
19 3
20 4
21 5