21
21
WWWSLLLLLLAAAAAAAAAAA
WWWXLLLLLLLAAAAAAAXXS
WWAXXLLLLLLLAAAAAXXWW
WWAAXPLLLLLLAAAAXXRWW
WAAAXPPPPLWWAAAAXRRWW
AAAAXPPPPWWWWWWWXRRWW
AARRXLLLLWWWWWWXXXRWW
FXXXXXLLLWWWWXXXPXWWW
LLLLLXXXLWWXXXPPPXWWW
LLLLLLLXXXXXWWPPPXWWA
LLLLLLLXRRRWWWPPPXXAA
LLLLLLAXWWWWWWWAAAXAA
LLAAAAAXWWWWWWAAAAXAA
AAAAAXXXWWWWWAAAAAXXA
AAXXXXRXWWWWWAAAAAAXA
SXXRRRRXXXWWWAAAAAAXF
AAAAAAAAAXXXWWLLLLLLL
AAAWWWWWWWWXXXXXLLLLL
AAAWXXXXXXXXRRRXXXLLL
AAWWXLLLLLLLLLLWWXPPP
AAWWSLLLLLLLLWWWWFPPP